Official Level a
16|
0|0|0|435c0000|
0|0|44480000|0|
44480000|0|44480000|43340000|
0|435c0000|41a00000|43700000|
41200000|43660000|42200000|43660000|
41f00000|43660000|41a00000|43700000|
42200000|43340000|41f00000|433e0000|
41f00000|43520000|41f00000|433e0000|
42200000|43340000|42a00000|432a0000|
42200000|43660000|42a00000|432a0000|
41f00000|43520000|42a00000|432a0000|
41f00000|43520000|42200000|43660000|
43160000|42f00000|43480000|42f00000|
43160000|42f00000|432f0000|43700000|
43480000|42f00000|432f0000|43700000|
43ac4aab|433e0000|43b6b555|433e0000|
43d20000|436b0000|43f00000|436b0000|
44188000|435c0000|442f0000|43480000|
44390000|43200000|44480000|43340000|
44250000|42a00000|442f0000|42f00000|
44250000|42a00000|44228000|42a00000|
44160000|42480000|43fa0000|42480000|
1|
43e10000|0|43e10000|43200000|
0|
8|
0|435c0000|41f00000|433e0000|
0|43340000|41f00000|43520000|
41200000|43520000|41200000|433e0000|
43a50000|42f00000|43be0000|42f00000|
43a50000|42f00000|43b18000|43700000|
43be0000|42f00000|43b18000|43700000|
44160000|42c80000|43fa0000|42c80000|
43fa0000|42480000|43fa0000|0|
10|
437f0000|42b40000|43898000|42b40000|
43848000|42c80000|43898000|42b40000|
43848000|42a00000|43898000|42b40000|
43b18000|432a0000|43b18000|43290000|
43b18000|431b0000|43b18000|43250000|
4405c000|431b0000|440ac000|431b0000|
44084000|43250000|440ac000|431b0000|
44084000|43110000|440ac000|431b0000|
44368000|42c80000|443a0919|42e448c6|
44368000|42c80000|443a0919|42c80000|
44368000|42c80000|44368000|42e448c6|
44098000|428c0000|44098000|42860000|
44098000|42700000|440c0000|42200000|
44098000|41f00000|440c0000|42200000|
44098000|41f00000|44070000|42200000|
44070000|42340000|44070000|42200000|
0|0|44480000|43700000|
41a00000|435c0000|
43ed8000|42700000|
