Official Level 3
12|
0|0|0|42700000|
0|0|43c80000|0|
42200000|42700000|0|42700000|
43c80000|0|43c80000|42700000|
43b40000|42700000|43c80000|42700000|
43480000|435c0000|42200000|42700000|
43480000|435c0000|43480000|435c0000|
43480000|435c0000|43480000|435c0000|
43480000|435c0000|43480000|435c0000|
43480000|435c0000|43480000|435c0000|
43480000|435c0000|43480000|435c0000|
43480000|435c0000|43b40000|42700000|
43480000|435c0000|43480000|435c0000|
43480000|435c0000|43480000|435c0000|
43480000|435c0000|43480000|435c0000|
43480000|435c0000|43480000|435c0000|
43480000|435c0000|43480000|435c0000|
43480000|430c0000|43988000|42dc0000|
14|
43480000|430c0000|42f00000|42700000|
43480000|430c0000|43480000|430c0000|
43480000|430c0000|43480000|430c0000|
43480000|430c0000|43480000|430c0000|
43480000|430c0000|43480000|430c0000|
43480000|430c0000|43480000|430c0000|
43480000|430c0000|438c0000|42700000|
43480000|430c0000|43480000|430c0000|
43480000|430c0000|43480000|430c0000|
43480000|430c0000|43480000|430c0000|
43480000|430c0000|43480000|430c0000|
43480000|430c0000|43480000|430c0000|
43480000|c1a00000|42f00000|42700000|
43480000|c1a00000|43480000|c1a00000|
43480000|c1a00000|43480000|c1a00000|
43480000|c1a00000|43480000|c1a00000|
43480000|c1a00000|438c0000|42700000|
43480000|c1a00000|43480000|c1a00000|
43480000|c1a00000|43480000|c1a00000|
43480000|c1a00000|43480000|c1a00000|
0|
8|
43480000|42700000|43480000|430c0000|
43480000|42700000|43480000|430c0000|
43480000|42700000|43480000|430c0000|
43480000|42700000|43480000|430c0000|
43480000|42700000|43480000|430c0000|
43480000|42700000|43480000|430c0000|
43480000|42700000|43480000|430c0000|
43480000|42700000|43480000|430c0000|
6|
43910000|430b0000|4389edce|43192463|
43910000|430b0000|4389edce|430b0000|
43910000|430b0000|43910000|43192463|
42f848c6|43192463|42dc0000|430b0000|
42f848c6|43192463|42dc0000|43192463|
42f848c6|43192463|42f848c6|430b0000|
0|0|43c80000|43700000|
41a00000|42480000|
43be0000|41f00000|
