Official Level 9
11|
41700000|43660000|420c0000|43660000|
41700000|43660000|c1700000|43700000|
420c0000|43660000|42820000|43700000|
41e80000|42d40000|41f00000|42c80000|
41a80000|41d00000|41a00000|41a00000|
41e80000|c2bc0000|41f00000|c2c80000|
41f00000|42c80000|42480000|42200000|
41a00000|41a00000|0|c2200000|
41f00000|c2c80000|42480000|c3200000|
0|43480000|0|c34d0000|
42480000|43480000|42480000|c34d0000|
41f00000|42c80000|42480000|42200000|
41a00000|41a00000|0|c2200000|
41f00000|c2c80000|42480000|c3200000|
42200000|c3968000|41200000|c3968000|
428c0000|c3a50000|42480000|c3af0000|
c1a00000|c3a50000|0|c3af0000|
2|
41200000|c3960000|41c80000|c38e8000|
42200000|c3960000|41c80000|c38e8000|
6|
41200000|433e0000|41200000|c3960000|
41a00000|43340000|41a00000|c3960000|
41f00000|43340000|41f00000|c3960000|
42200000|433e0000|42200000|c3960000|
42480000|43480000|41c80000|432f0000|
0|43480000|41c80000|432f0000|
0|
9|
42340000|42960000|42820000|42960000|
42820000|42960000|425c0000|42820000|
42820000|42960000|425c0000|42aa0000|
40a00000|c0a00000|c1700000|c0a00000|
c1700000|c0a00000|c0a00000|40a00000|
c1700000|c0a00000|c0a00000|c1700000|
42340000|c2fa0000|42820000|c2fa0000|
42820000|c2fa0000|425c0000|c2e60000|
42820000|c2fa0000|425c0000|c3070000|
0|c3c80000|42480000|43700000|
41c80000|435c0000|
41c80000|c3af0000|
