Official Level 1
b|
43200000|43340000|43700000|42dc0000|
0|43480000|43200000|43340000|
0|43160000|42c80000|43480000|
43820000|42f00000|42c80000|43480000|
43960000|42500000|43c80000|42480000|
0|43480000|0|0|
43c80000|42480000|43c80000|0|
43c80000|0|0|0|
438c0000|42be0000|43700000|42dc0000|
43870000|42dc0000|438c0000|42be0000|
43870000|42dc0000|43820000|42f00000|
b|
43a00000|43340000|43af0000|43160000|
43af0000|43340000|43a00000|43160000|
43a78000|43480000|43a78000|435c0000|
43a28000|43520000|43a78000|435c0000|
43ac8000|43520000|43a78000|435c0000|
436f2463|434ddb9d|43610000|435c0000|
43610000|435c0000|43610000|434ddb9d|
436f2463|435c0000|43610000|435c0000|
43898000|435c0000|43909232|434ddb9d|
43909232|435c0000|43898000|435c0000|
43898000|434ddb9d|43898000|435c0000|
0|
0|
25|
42b40000|41a00000|42a28000|42340000|
42b40000|41a00000|42c58000|42340000|
42aa0000|420c0000|42be0000|420c0000|
42b40000|41200000|42820000|420c0000|
42b40000|41200000|42e60000|420c0000|
42b40000|42700000|42820000|420c0000|
42b40000|42700000|42e60000|420c0000|
43070000|42dc0000|43110000|42dc0000|
430c0000|42e60000|43110000|42dc0000|
430c0000|42d20000|43110000|42dc0000|
42aa0000|42dc0000|42960000|42dc0000|
42a00000|42e60000|42960000|42dc0000|
42a00000|42d20000|42960000|42dc0000|
430c0000|41c80000|430c0000|42340000|
43020000|420c0000|430c0000|41c80000|
43160000|420c0000|430c0000|41c80000|
43bb8000|420c0000|43bb8000|425c0000|
43b68000|42340000|43bb8000|420c0000|
43c08000|42340000|43bb8000|420c0000|
43c30000|42910000|43b68000|42700000|
43b68000|42700000|43ac8000|42c80000|
43c30000|42910000|43be0000|42b90000|
43b18000|42a00000|43be0000|42b90000|
43b68000|42700000|43be0000|42b90000|
43b18000|42a00000|43c30000|42910000|
42c80000|428c0000|42c80000|42c80000|
428c0000|42c80000|42c80000|42c80000|
42f00000|428c0000|42f00000|42c80000|
428c0000|42f00000|42c80000|42f00000|
42c80000|428c0000|42f00000|428c0000|
428c0000|42c80000|428c0000|42f00000|
42c80000|42f00000|42c80000|43160000|
42f00000|42c80000|43160000|42c80000|
42f00000|42f00000|42f00000|43160000|
42f00000|42f00000|43160000|42f00000|
42c80000|43160000|42f00000|43160000|
43160000|42c80000|43160000|42f00000|
0|0|43c80000|43700000|
42480000|4323cccd|
43bb8000|41c80000|
