Official Level 4
e|
0|437a0000|42c80000|43870000|
43480000|437a0000|43960000|43870000|
43c80000|43480000|43af0000|435c0000|
43c80000|431b0000|43bb8000|43250000|
43a50000|43110000|43870000|43110000|
0|c2c80000|0|437a0000|
43c80000|c2c80000|43c80000|43820000|
0|c2c80000|43c80000|c2c80000|
43020000|43110000|428c0000|43110000|
0|42b40000|428c0000|42c80000|
43020000|425c0000|428c0000|42820000|
43a50000|425c0000|43870000|425c0000|
43a50000|425c0000|43c80000|0|
43a50000|c1a00000|43870000|c1a00000|
5|
42c80000|438c0000|43480000|43820000|
43960000|438c0000|43c80000|43820000|
43960000|43480000|43960000|43160000|
43960000|431b0000|43020000|431b0000|
43870000|42820000|43020000|42820000|
0|
0|
13|
43a00000|43610000|4398edce|436f2463|
43a00000|43610000|4398edce|43610000|
43a00000|43610000|43a00000|436f2463|
43ac8000|43160000|43b39232|43242463|
43ac8000|43160000|43b39232|43160000|
43ac8000|43160000|43ac8000|43242463|
42c80000|42c80000|42e448c6|42e448c6|
42c80000|42c80000|42e448c6|42c80000|
42c80000|42c80000|42c80000|42e448c6|
43520000|41900000|433e0000|41900000|
43520000|41900000|43480000|41000000|
43520000|41900000|43480000|41e00000|
43960000|c1a00000|43160000|c1a00000|
43200000|c1f00000|43160000|c1a00000|
43200000|c1200000|43160000|c1a00000|
43160000|c1f00000|430c0000|c1a00000|
43160000|c1200000|430c0000|c1a00000|
430c0000|c1f00000|43020000|c1a00000|
430c0000|c1200000|43020000|c1a00000|
0|c2c80000|43c80000|43960000|
42480000|4379cccd|
42e60000|c1a00000|
